2 2 2 2 2 2 2 2 2 2 2 2 2 2 2 2 2 2 2 2 2 2 2
2 0 0 0 0 6 3 7 0 0 0 0 0 0 0 0 0 0 0 0 0 0 2
2 0 0 0 0 6 3 7 0 0 0 0 0 0 0 0 0 0 0 0 0 0 2
2 0 0 0 0 6 3 7 0 0 0 0 0 0 0 0 0 0 0 0 0 0 2
2 0 0 0 0 6 3 7 0 0 0 0 0 0 0 0 0 0 0 0 0 0 2
2 0 0 0 0 6 3 13 5 5 5 5 11 0 0 0 0 0 0 0 0 0 2
2 0 0 0 0 6 3 3 3 3 3 3 7 0 0 0 0 0 0 0 0 0 2
2 0 0 0 0 10 4 4 4 4 12 3 7 0 0 0 0 0 0 0 0 0 2
2 0 0 0 0 0 0 0 0 0 6 3 7 0 0 0 0 0 0 0 0 0 2
2 0 0 0 0 0 0 0 0 0 6 3 7 0 0 0 0 0 0 0 0 0 2
2 0 0 0 0 0 0 0 0 0 6 3 7 0 0 0 0 0 0 0 0 0 2
2 0 0 0 0 0 0 0 0 0 6 3 7 0 0 0 0 0 0 0 0 0 2
2 0 0 0 0 0 0 0 0 0 6 3 13 5 5 5 5 11 0 0 0 0 2
2 0 0 0 0 0 0 0 0 0 6 3 3 3 3 3 3 7 0 0 0 0 2
2 0 0 0 0 0 0 0 0 0 10 4 4 4 4 12 3 7 0 0 0 0 2
2 0 0 0 0 0 0 0 0 0 0 0 0 0 0 6 3 7 0 0 0 0 2
2 0 0 0 0 0 0 0 0 0 0 0 0 0 0 6 3 7 0 0 0 0 2
2 0 0 0 0 0 0 0 0 0 0 0 0 0 0 6 3 7 0 0 0 0 2
2 0 0 0 0 0 0 0 0 0 0 0 0 0 0 6 3 7 0 0 0 0 2
2 2 2 2 2 2 2 2 2 2 2 2 2 2 2 2 2 2 2 2 2 2 2